1111111111111
100100P0000C1
10E0011111001
1000C1C100001
1111111111111