1111111111111
1P0010CC00001
1001E01111001
100101000C001
110010CC00C01
1C0CCCCCCC0C1
110101000C001
100101000C001
1111111111111