1111111111111
10010P0000001
10E0111111001
100xC10000001
1111111111111