1111111111111
1P00000000001
10E1011111001
1001C10C00001
1111111111111