1111111111111
1P0000CC00001
1001E01111001
1001010000001
1111111111111