1111111111111111
100C00000C0000E1
1000010001111101
10C0100C00001001
1001000000010C01
10111100C0100001
1000010001111101
1P00C0000C00C001
1111111111111111