1111111111111
1E0000PC00001
1111111111111