111111111111111111111111111111
1C1C01000000100010000001000001
10110101111010P010111101011101
101001C100001000101001C101C101
101011110111110110101111010101
101010010010C101000000000101C1
101011011010110101011110110111
1000000000100101C10101000001C1
101011101111010111010101111101
10101C101C01000000000100100001
101010101101110111111110101111
1C10100001000000000100000010C1
111010110111111111110111011011
1000101100010000000001C1010001
101110111101011011110101010101
101C001C0001010000C10001000101
101111111101011111111111110101
1000000010000100000000C1000101
11101C1111111101110111110101C1
1C1011100010000100000001010111
100000001010111111111011010001
11111111101001000000101C011101
1C1010001011010111011011110001
10100010001001010000000001C111
1010111110101101110110111111C1
1010001C1000100010001000000001
10111010101110E011101110111111
100000100000100010000C100000C1
111111111111111111111111111111